readlines|readlines|pyright
readl|readline|pyright
ap|append|pyright
cl|close|pyright
bina|binary_img|pyright
orderpo|orderPoints|pyright
ada|adaPoint|pyright
maxco|max_contour|pyright
getboxp|getBoxPoint|pyright
box|boxes|pyright
max_cou|max_contour|pyright
getbo|getBoxPoint|pyright
max_con|max_contour|pyright
find|findMaxContour|pyright
imgto|imgtours|pyright
resizeI|resizeImg|pyright
res|resize|pyright
h|h|pyright
hei|height|pyright
getCan|getCanny|pyright
ker|kernel|pyright
imag|image|pyright
imu|imutils|python-import
disp|display_alerts|pyright
up|screen_updating|pyright
Tr|True|pyright
scr|screen_updating|pyright
she|sheets|pyright
fals|False|pyright
Fa|False|pyright
A|App|pyright
get|getTableNames|pyright
tab|tab_name|pyright
fet|fetchall|pyright
curs|cursor|pyright
cu|cursor|pyright
con|connect|pyright
readfr|readFromSqllite|pyright
__na|__name__|pyright
false|false|around
true|true|around